11111111
1P0C1011
1000C011
11100011
1C0C0011
1101E011
11111111
