11111111111111111111111111111111
1C00001C100000011111100000001111
1010P01000100100C000000000000001
10100010100111111111111100000101
10001000100000001C00000000000101
1001110000000000011C0000000001C1
10001000000E000000001C0000010011
101000001000D00C0000101111010001
10011100000000000000100010101001
10C0000C0000000000000110000C0001
11111111111111111111111111111111