111111
1P0CE1
111111
1D1111
111111
